abandon: (verb) To leave completely and finally
abstract: (adj) Thought of apart from concrete realities, specific objects, or actual instances
academy: (noun) A secondary or high school, especially a private one
access: (noun) The ability, right, or permission to approach, enter, speak with, or use; admittance
accommodate: (verb) To do a kindness or a favor to
accompany: (verb) To go along or in company with; join in action
accumulate: (verb) To gather or collect, often in gradual degrees
accurate: (adj) Free from error or defect; consistent with a standard
achieve: (verb) To bring to a successful end
acknowledge: (verb) To admit to be real or true; recognize the existence
acquire: (verb) To come into possession or ownership of
adapt: (verb) To make suitable to requirements or conditions
adequate: (adj) As much or as good as necessary for some requirement or purpose
adjacent: (adj) Lying near, close, or contiguous
advocate: (verb) To speak or write in favor of
aid: (verb) To provide support for or relief to
allocate: (verb) To set apart for a particular purpose; assign or allot
ambiguous: (adj) Open to or having several possible meanings or interpretations
amend: (verb) To change for the better
benefit: (noun) Something that is advantageous or good
cease: (verb) To stop; discontinue:
circumstance (noun) A condition with respect to time that accompanies a fact or event
clarify: (verb) To make (an idea, statement, etc.) clear or intelligible; to free from ambiguity. 
coherent: (adj) Logically connected; consistent
coincide: (verb) To occupy the same place in space, the same point or period in time, or the same relative position
collapse: (verb) To fall or cave in; crumble suddenly
commission: (noun) The act of committing or entrusting a person with supervisory power or authority
commodity: (noun) An article of trade or commerce, especially a product as distinguished from a service
compensate: (verb) To provide or be an equivalent; make up
comprise: (verb) To consist of; be composed of
conceive: (verb) To form (a notion, opinion, purpose, etc.)
confine: (verb) To enclose within bounds; limit or restrict
consent: (Noun) permission, approval, or agreement
constitute: (verb) To compose; form
constrain: (verb) To force, compel, or oblige
consult: (verb) To seek advice or information from; ask guidance from
contemporary: (adj) Existing, occurring, or living at the same time; belonging to the same time
contrary: (adj) Opposite in nature or character; diametrically or mutually opposed
debate: (noun) A discussion, as of a public question in an assembly, involving opposing viewpoints
derive: (verb) To receive or obtain from a source or origin (usually followed by from)
differentiate: (verb) To form or mark differently from other such things; distinguish
empirical: (adj) Provable or verifiable by experience or experiment
enhance: (verb) To raise to a higher degree; intensify; magnify
entity: (noun) Something that has a real existence; thing
equate: (verb) To regard, treat, or represent as equivalent
erode: (verb) To eat into or away; destroy by slow consumption or disintegration
explicit: (adj) Clearly developed or formulated
exploit: (noun) A striking or notable deed; feat; spirited or heroic act
external: (adj) Of or relating to the outside or outer part; outer
facilitate: (verb) To make easier or less difficult; help forward (an action, a process, etc)
fluctuate: (verb) To change continually; shift back and forth; vary irregularly
hence: (adverb) As an inference from this fact; for this reason; therefore
hierarchy: (noun) Any system of persons or things ranked one above another
implicit: (adj) implied, rather than expressly stated
incentive: (noun) Something that incites to an action or greater effort, as a reward offered for increased productivity
induce: (verb) To lead or move by persuasion or influence, as to some action or state of mind
inevitable (adj) Unable to be avoided, evaded, or escaped; certain; necessary
infer: (verb) To derive by reasoning; conclude or judge from premises or evidence
infrastructure: (noun) The basic, underlying framework or features of a system or organization
inherent: (adj) Existing in someone or something as a permanent and inseparable element, quality, or attribute
inhibit: (verb) To restrain, hinder, arrest, or check (an action, impulse, etc.)
injure: (verb) To do or cause harm of any kind to; damage; hurt; impair
instance: (noun) A case or occurrence of anything
integrate: (verb) To bring together or incorporate (parts) into a whole
integrity: (noun) Adherence to moral and ethical principles; soundness of moral character; honesty
intermediate: (adj) Being, situated, or acting between two points, stages, things, persons, etc.
internal: (adj) situated or existing in the interior of something; interior
intervene: (verb) To occur or happen between other events or periods
intrinsic: (adj) Belonging to a thing by its very nature
levy: (noun) The amount owed or collected
manipulate: (verb) To manage or influence skillfully, especially in an unfair manner
migrate: (verb) To go from one country, region, or place to another
negate: (verb) To deny the existence, evidence, or truth of
notwithstanding: (prepos) in spite of; without being opposed or prevented by
orient: (verb) to familiarize (a person) with new surroundings or circumstances, or the like
parallel: (adj) Extending in the same direction, equidistant at all points, and never converging or diverging
passive: (adj) Not involving visible reaction or active participation:
perceive: (verb) To become aware of, know, or identify by means of the senses
persist: (verb) To last or endure tenaciously
perspective: (noun) The state of existing in space before the eye
potential: (adj) Capable of being or becoming
practitioner: (noun) A person engaged in the practice of a profession, occupation, etc
precise: (adj) Being exactly that and neither more nor less
presume: (verb) To take for granted, assume, or suppose
prohibit: (verb) To forbid (an action, activity, etc.) by authority or law
prospect: (noun) Something in view as a source of profit.
protocol: (noun) The customs and regulations dealing with diplomatic formality, precedence, and etiquette
pursue: (verb) To follow in order to overtake, capture, kill, etc.; chase
qualitative: (adj) To follow in order to overtake, capture, kill, etc.; chase
radical: (adj) Of or going to the root or origin; fundamental
refine: (verb) To bring to a finer state or form by purifying
regime: (noun) A ruling or prevailing system
regulate: (verb) To control or direct by a rule, principle, method, etc.
reinforce: (verb) to strengthen with some added piece, support, or material
reluctance: (noun) Unwillingness; disinclination
restrain: (verb) To hold back from action; keep in check or under control; repress:
revise: (verb) To alter something already written or printed, in order to make corrections, improve, or update
rigid: (adj) Stiff or unyielding; not pliant or flexible; hard
scheme: (noun) A plan, design, or program of action to be followed; project
significant: (adj) Having or expressing a meaning; indicative; suggestive
sole: (adj) Being the only one; only
subordinate: (adj) Of less importance; secondary
subsequent: (adj) Occurring or coming later or after (often followed by to)
supplement: (verb) To complete, add to, or extend by a supplement.
transmit: (verb) To send or forward, as to a recipient or destination; dispatch; convey
unify: (verb) To make or become a single unit; unite
utilise: (verb) To put to use; turn to profitable account
welfare: (noun) The good fortune, health, happiness etc, of a person
whereas: (conjuct) While on the contrary
whereby: (conjuct) By what or by which; under the terms of which